17-EQUATIONS-THAT-CHANGED-THE-WORLD	book	도서
2018-01-20	diary-2018	2018 Diary
airplain-rule	proverb	속담, 법칙, 관용어 모음
Algorithms-to-Live-By	book	도서
ALPHAGO	movie	영화, TV 시리즈
Bayes-theorem	math	수학
Bill-Atkinson-productivity	legend	레전드 모음
book	media	미디어
Boy-Scout-Rule	proverb	속담, 법칙, 관용어 모음
braille-pattern-chars	what	what
brew	command-line	커맨드 라인 명령어 및 사용법 모음
Brooks-s-law	proverb	속담, 법칙, 관용어 모음
builder-pattern	design-pattern	디자인 패턴
Clean-Code	book	도서
Code-Complete-2	book	도서
command-line	tools	tools
Conway-s-law	proverb	속담, 법칙, 관용어 모음
cookie-problem	problem	문제
Copernican-Principle	proverb	속담, 법칙, 관용어 모음
Cromwell-s-rule	math	수학
Design-for-Hackers	book	도서
DevOps-Troubleshooting	book	도서
df	command-line	커맨드 라인 명령어 및 사용법 모음
diary-2018	diary	Diary
dice-problem	problem	문제
DIRK-GENTLY-S-HOLISTIC-DETECTIVE-AGENCY	movie	영화, TV 시리즈
DOM-Enlightenment-by-Cody-Lindley	book	도서
du	command-line	커맨드 라인 명령어 및 사용법 모음
Edsel-edict	proverb	속담, 법칙, 관용어 모음
Effective-Java	book	도서
fish-shell	command-line	커맨드 라인 명령어 및 사용법 모음
frac1e	math	수학
geacron	useful-site	유용한 웹 서비스 모음
Geek-Atlas	book	도서
gerald-weinberg-language-king	legend	레전드 모음
git-checkout-specific-files	til	Today I Learned
GoF-Design-Pattern	book	도서
google-search-console-remove-outdated-content	useful-site	유용한 웹 서비스 모음
googling	how-to	HOW TO
Gradle	tools	tools
groovy	programming-language	프로그래밍 언어
Grote-Reber-home-made-radio-astronomy	legend	레전드 모음
HELL-BOY	book	도서
HOT-FUZZ	movie	영화, TV 시리즈
http-message	what	what
HTTP-no-Kyokasho	book	도서
HTTP-THE-DEFINITIVE-GUIDE	book	도서
James-Gosling-super-programmer	legend	레전드 모음
Java	programming-language	프로그래밍 언어
java_home	command-line	커맨드 라인 명령어 및 사용법 모음
John-von-Neumann	legend	레전드 모음
labs-strava-com-heatmap	useful-site	유용한 웹 서비스 모음
Las-chicas-del-cable	movie	영화, TV 시리즈
legend	clipping	글 모음 및 요약
letter-case	why	why
locomotive-problem	problem	문제
Lubarsky-s-Law-of-Cybernetic-Entomology	proverb	속담, 법칙, 관용어 모음
mac-apps	tools	tools
mathjax-latex	how-to	HOW TO
MnM-problem	problem	문제
Monty-Hall-problem	problem	문제
movie	media	미디어
Mythical-Man-Month	book	도서
No-Silver-Bullet	proverb	속담, 법칙, 관용어 모음
Object-equals	Java	Java
Object-hashCode	Java	Java
Object-toString	Java	Java
orange-juice-test	proverb	속담, 법칙, 관용어 모음
Postel-s-law	proverb	속담, 법칙, 관용어 모음
private-constructor	Java	Java
PROFESSIONAL-SOFTWARE-DEVELOPMENT	book	도서
review	media	미디어
review-2018	review	리뷰 모음
RFC	what	what
SCIENTIFIC-AMERICAN-The-Secrets-Of-Consciousness	book	도서
secret-of-consulting	book	도서
secretary-problem	math	수학
Shortcat	mac-apps	유용한 Mac 애플리케이션 모음
Shunsho-juwa	book	도서
Software-Craftsman	book	도서
Software-Engineering-Code-of-Ethics	clipping	글 모음 및 요약
special-chars	what	what
static-factory-method-pattern	design-pattern	디자인 패턴
Take-the-Bully-by-the-Horns	book	도서
TETRIS-EFFECT	book	도서
TEXT-BOOK-OF-THE-WEB-ENGINEER	book	도서
The-Jargon-File	book	도서
THE-NEXT-BIG-BLUE-COLLAR-JOB-IS-CODING	clipping	글 모음 및 요약
toda-seiji-scientia	book	도서
top	command-line	커맨드 라인 명령어 및 사용법 모음
trouble-shooting-node-7-install	til	Today I Learned
uptime	command-line	커맨드 라인 명령어 및 사용법 모음
URI	what	what
use-java-primitive-type-for-performance	Java	Java
useful-site	tools	tools
utterances	useful-site	유용한 웹 서비스 모음
vim-conceallevel	Vim	Vim
vim-f-hangul	Vim	Vim
vim-rest-console	Vim	Vim
vim-ycm-python3	Vim	Vim
vimium	web-browser-extension	유용한 웹 브라우저 확장 프로그램 모음
vimwiki	Vim	Vim
von-neumann-extractor	algorithm	알고리즘
Walking-Dead	movie	영화, TV 시리즈
web-browser-extension	tools	tools
why-http-80-https-443	why	why
yaml	programming-language	프로그래밍 언어
Zipf-s-law	proverb	속담, 법칙, 관용어 모음
그림으로-보는-서양검술-메모	book	도서
미세먼지-정보	useful-site	유용한 웹 서비스 모음
전생검신	book	도서
한국과학문학상-수상작품집-제2회	book	도서
